11111111111111111111111111111
13300000000111111111111111111
10000000000111111111111111111
10022222000111111111111111111
10022222000111111111111111111
10000000000111111111111111111
10000000000111111111111111111
10000000000100000000011111111
10000000000550000000011111111
10000004444550000000011111111
10000004444100000000011111111
11111111111111111111111111111
11111111111111111111111111111
11111111111111111111111111111
11111111111111111111111111111
11111111111111111111111111111
11111111111111111111111111111
11111111111111111111111111111
11111111111111111111111111111
11111111111111111111111111111
11111111111111111111111111111
11111111111111111111111111111
11111111111111111111111111111
11111111111111111111111111111
11111111111111111111111111111
11111111111111111111111111111
11111111111111111111111111111
11111111111111111111111111111
11111111111111111111111111111
11111111111111111111111111111
