11111111111111111111111111111
10000000000111111111111111111
10000000000111111111111111111
10022222000111111111111111111
10022222000111111111111111111
10000000000111111111111111111
10000000000111111111111111111
10000000000100000000011111111
10000000000000000000011111111
10000000000000000000011111111
10000000000100000000011111111
11111111111111111111111111111
11111111111111111111111111111
11111111111111111111111111111
11111111111111111111111111111
11111111111111111111111111111
11111111111111111111111111111
11111111111111111111111111111
11111111111111111111111111111
11111111111111111111111111111
11111111111111111111111111111
11111111111111111111111111111
11111111111111111111111111111
11111111111111111111111111111
11111111111111111111111111111
11111111111111111111111111111
11111111111111111111111111111
11111111111111111111111111111
11111111111111111111111111111
11111111111111111111111111111
